?????????????????????
?...?...........?...?
?.?.?.?.?????.?.?.?.?
?.?...?...?...?...?.?
???.?????.?.?????.???
?.?...?.......?...?.?
?.?.?.?.??@??.?.?.?.?
?...?...?@@@?...?...?
?.?.?.?.?????.?.?.?.?
?.?...?.......?...?.?
???.?????.?.?????.???
?.?...?...?...?...?.?
?.?.?.?.?????.?.?.?.?
?...?.....C.....?...?
?????????????????????